R 1920 1080

NO ./textures/metal.xpm
SO ./textures/brick.xpm
WE ./textures/face.xpm
EA ./textures/mountains.xpm

S ./textures/barrel.xpm

F 51,51,26
C 51,0,0

111111
1S1
111
1