R 1920 1080

NO ./textures/metal.xpm
SO ./textures/brick.xpm
WE ./textures/marbface.xpm
EA ./textures/mountains.xpm

S ./textures/barrel.xpm
F 51,51,26
C 51,0,0

        1111111111111111111111111
        1000000000110000000000001
        10110000011100222222000W1
        1001000000000002020200001
111111111011000001110000000000001
100000000011000001110111111111111
11110111111111011100000010001
11101111111110111010100100011
11000000110101011100000010001
10000000000000001100000010001
10000000000000001101010010001
110000011101010111110111100111
11110111 1110101 101111010001
11111111 1111111 111111111111
