R 1920 1080

NO ./textures/metal.xpm
SO ./textures/brick.xpm
WE ./textures/face.xpm
EA ./textures/mountains.xpm

S ./textures/barrel.xpm

F 51,51,26
C 51,0,0

1111111111111111111 11111111111
1000000000000000001 10000000001
1000000000000000001 11111111111
10000000000S0000001
1110000000000000001
1 10000000000000001
1111111111111111111